#######
#    $#
#   . #
#    @#
#######