#######
# $ . #
#     #
#    @#
#######