##########
#        #
#  .$@   #
#   . $  #
#        #
#        #
##########