########
## @ ###
##$#$###
## . $ #
#  .*# #
#  .   #
########