########
# .@$  #
# . $  #
# . $  #
#      #
########