#######
#     #
#.$ @ #
#     #
#######