##########
#  .  .  #
# $# $$#@#
#  #     #
### ##  ##
## .  $ ##
#####   ##
###.   ###
##########
