##########
#.  #   .#
# #$ #  ##
#   #@$$ #
#.       #
#    ## ##
##########
