##########
#   @   .#
# $ # $  #
# # # #$##
#   . .  #
##########
