##########
#   ### ##
# #$##   #
#    #   #
# #$##   #
#   #@$$ #
#       ##
#....## ##
##########
