#######
#. ####
#.@ ###
#. $###
##$ ###
## $  #
##    #
##  ###
#######