#########
#   #   #
# $$@$  #
#   # $ #
###   #.#
# .. .  #
#   #####
#########
