#########
# ..#####
# $     #
#  #$#  #
# @ .$  #
#########
