##########
#   #    #
# # # $$ #
# . .  $@#
#######  #
# .      #
##########
