###############
#            @#
# $         $ #
#  $ #...# $  #
# $ $.#.#.$ $ #
# $ ...#... $ #
# $ $.#.#.$ $ #
#  $ #...# $  #
# $         $ #
#             #
###############
