################
############   #
###########    #
########  # $ ##
#####  ####$ $##
#####     $ $ ##
##### ## $ $ $##
####  .#  $ $ ##
####  .#      ##
##### ##########
#.... @  #######
#....    #######
##  ############
################