########
#      #
# .$@  #
# *    #
#      #
########
